9 9 2 
111111111
222222222
111121111
122221111
111111111
111121111
111123111
111121111
111120111
